5 5 4 1 0 1
# ###
# # #
# # #
#   #
# ###
